0 0 0 0 0 0 0 4 4 4 4 4 4 4 4 0
0 0 0 0 0 0 0 4 6 0 4 0 0 0 4 0
0 0 0 0 0 0 0 4 8 0 4 3 5 0 4 0
0 0 4 4 4 4 4 4 0 0 3 0 4 0 4 0
0 0 4 0 2 0 0 4 0 0 0 0 2 0 4 0
0 0 4 5 4 4 0 2 0 4 4 9 4 7 4 0
0 0 4 0 0 5 0 9 8 9 0 0 4 4 4 0
0 4 4 4 2 4 4 4 4 4 0 0 0 0 4 0
0 4 0 0 0 2 0 0 0 0 0 4 4 0 4 0
0 4 1 0 0 4 4 4 4 4 0 0 0 6 4 0
0 4 4 4 4 4 0 0 0 4 4 4 4 4 4 0
0 0 0 0 0 0 0 0 0 0 0 0 0 0 0 0
0 0 0 0 0 0 0 0 0 0 0 0 0 0 0 0
4 0 4 0 4 0 0 4 0 0 4 0 0 0 4 0
0 0 4 0 4 4 0 4 0 4 4 4 0 4 4 4
0 0 0 0 0 0 0 4 0 0 0 0 0 0 4 0
0 0 0 0 0 0 0 0 0 0 0 0 0 0 0 0
1 0 2 0 3 0 5 0 10 0 0 0 0 0 0 0
7 0 9 0 6 0 8 0 11 0 0 0 0 0 0 0