4 4 4 4 4 4 4 4 4 4 4
4 1 0 2 0 4 0 0 0 6 4
4 4 0 4 0 4 0 0 0 0 4
0 4 4 4 3 0 0 0 0 0 4
0 4 0 5 0 4 0 0 7 0 4
0 4 4 4 4 4 4 4 4 4 4