4 4 4 4 4 4
4 1 0 4 6 4
4 4 0 4 2 4
0 4 0 0 3 4
0 4 0 0 0 4
0 4 4 4 4 4