0 0 0 0 0 4 4 4 0 0 0
0 0 4 4 4 4 6 4 0 0 0
0 0 4 0 0 0 0 4 0 0 0
4 4 4 4 0 4 0 4 4 0 0
4 0 4 0 5 4 0 0 4 4 4
4 0 0 3 0 2 0 3 4 7 4
4 2 4 0 0 4 0 0 0 0 4
4 0 0 1 0 4 3 0 0 0 4
4 4 0 0 0 4 0 0 4 6 4
0 4 4 4 4 4 4 4 4 4 4